MMMMMMMMMMMMMMMMMMMMMMMMMMMMMMMMMMMMMMMMMMMMMMMMMM
M0000000000000000000000000000M000000000M000000000M
M0000000000000000000000000000M0000000000000000000M
M00000000000000000EEE0000000000000000000000000000M
M00000000000000000EEEE000000000000000000000000000M
MEEEEPEE000000000EEEEE000000000000000000000000000M
M00000EEE00000EEEE0000000000000000000000000000000M
M000000EEE000EE000000000000000000000000000000000MM
M0000000EEEEEE00000000000000000000000000000000000M
M00000000EEE0000000000000000000000000000000000000M
M0000000000EE000000000000000000000000000000000000M
M00000000000EE00000000000000000000000000000000000M
M000000000000E00000000000000000000000000000000000M
M000000000000E00000000000000000000000000000000000M
M000000000000P00000000000000000000000000000000000M
M000000000000E000000000000000000000000000000000MMM
M000000000000EE0000000000000000000000000000000000M
M0000000000000EE000000000000000000000000000000000M
M00000000000000E00EEPEE00000000000000000000000000M
M00000000000000EEEE000E00000000000000000000000000M
M0000000000000000EE000EEE000000000000000000000000M
M00000000000000000000EEEEEEE000000000000000000000M
M00000000000000000000EEEEEEE000000000000000000000M
M00000000000000000000PPPPPPP000000000000000000000M
M00000000000000000000PPPPPPP000000000000000000000M
M00000000000000000000PPPPPPP000000000000000000000M
M00000000000000000000EEEEEEE000000000000000000000M
M00000000000000000000EEEEEEE000000000000000000000M
M00000000000000000000000EEE000EE00000000000000000M
M0000000000000000000000000E000EEEE000000000000000M
M0000000000000000000000000EEPEE00E000000000000000M
M00000000000000000000000000000000EE00000000000000M
M000000000000000000000000000000000EE0000000000000M
M0000000000000000000000000000000000E0000000000000M
MMM00000000000000000000000000000000P0000000000000M
M0000000000000000000000000000000000E0000000000000M
M0000000000000000000000000000000000E0000000000000M
M0000000000000000000000000000000000EE000000000000M
M00000000000000000000000000000000000EE00000000000M
M000000000000000000000000000000000000EE0000000000M
M0000000000000000000000000000000000000EEE00000000M
M00000000000000000000000000000000000EEEEEE0000000M
MM00000000000000000000000000000000EE000EEE000000M
M0000000000000000000000000000000EEEE00000EEE00000M
M000000000000000000000000000EEEEE000000000EEPEEEEM
M000000000000000000000000000EEEE00000000000000000M
M0000000000000000000000000000EEE00000000000000000M
M0000000000000000000M0000000000000000000000000000M
M000000000M000000000M0000000000000000000000000000M
MMMMMMMMMMMMMMMMMMMMMMMMMMMMMMMMMMMMMMMMMMMMMMMMMM