d0000mmb0000mmm
0m0mm000000m0mm
000000mmmmmm0mm
m0mm000mmmm0b0m
m000mm0m000m0mm
mmm0mm000mmm0mm
m00000m0mmm00mm
m0m0m0m0mmm00mm
m000m0m0mm00mmm
m0m0m0m0mm00mmm
0000m0m0m00mmmm
0m0mmm00m000mmm
0mm0000m00m0mmm
mb00mmmm00m0mmm
mmm00000000000a