d000000000000bm
00mmmmmmmmmmm00
0m000m0b0m000m0
bm0mm0m0m0mm000
0m0000m0m0000mm
00m0m00000mmm00
m0000mm0mm00000
m0mm0000000mm0m
m00m0mm0mm0m00m
m0mm000000mmm00
000m00m0m00mbm0
0m0m00mbmm0m0m0
0m0m00mmm00m0m0
000m0000m0mm0m0
mm0bmmm000000ma